15
15
***********P***
**** **     ***
**        *****
*****   *******
***    ********
******   ******
***    ********
*****  ********
****        ***
**********    *
*********** ***
*******      **
**********   **
********    ***
**********S****