5
5
*P***
*   *
*   *
*  **
**S**