10
10
*****P****
* **  * **
****  ****
****     *
*******  *
*****    *
***     **
*****   **
******   *
********S*